. # # # # # # # # # # # # # # # # # # # # # # # # # # # # # # #
# . . # . . # # . . . . # . . . # . . # . . . . . # # . # . . #
# . . # . . # # . . . . # # . . # . . # . . . # # # # . # . . #
# . . . . . . # . # # # # . . . . . # # . . # # . . # . # . . #
# # # # # # . . . . # . # # . . . . # # . . # # . . # . . . . #
# . . . . . . . . # # . # # . . # # # # . # # # . . # . . . . #
# . . . # # # . . # # . # . . # # # . . . . . # # . # . # # # #
# # # # # # # . . # # . # . . # . # # # . # # # # . . . # # # #
# # # . . . # # . . . . # . . # . # . # . . . . . . . # # . . #
# . # . . . . . . # # . . . . . . . . . . . . . # # # # # . . #
# . . . . # . . . # . . . # . . . # # . # # # . . . # . . . . #
# . . . . # # . . # # . . # # # # # # . . # # # . . . . . . . #
# . . . . # . . # # . . . . . # # . . . . . . # . # . . . . . #
# . . # # # . . # # # # # . . # # . . # . # . # # # . . # # . #
# . # # . . . # # . . . . . . . # # # # . # . # . . . . . # . #
# # # # # # # # . . . . . . # # # # # # # # . # # . . # # # . #
# . . . . . . . . . . . . . . . . . . . . # . # # . . # # . . #
# # # . . . # . # # . # . . . . # # . # . # # # . . . . # # . #
# . . . . . # . # . . # . # . . . # . # # # # # . # . # # . . #
# . . . # . # . # # # # . # . . # # . . . . . # . # . # # . . #
# . # . # . # # # # # . . # . . . # # . # . . # # # . . # # . #
# . # # # . # . . . . . . # . # # # . . # . # # . . . # # . . #
# # # # . . # # . . . . . # . . # # . . # . . # . # . . # # . #
# . . . . . # . . . # # # # . . . # . . # # # # # # . . # # . #
# . # . . . # . . . # . . . . . # # # # # # # . # # # . # # . #
# # # # # # # . . . # . # # . . . . . . . . . . . . # . # # . #
# . . . . . . . . . # # # # . # # # . # . # # # # # # . # # . #
# # # # # # # # . # # # . . . . . # # # . . . . . . # . # # . #
# . . . . . . . . # . # # # . . . . # # . . # # # # # # # . . #
# . . . . # # # # # . . . . . # # # # . . . . . . . . . # . . #
# . . . . # . . . . . . . . . . . . # . . . . . . . . . # . . #
# # # # # # # # # # # # # # # # # # # # # # # # # # # # # # . #
