B........B
.##.##.##.
##......##
...####...
...#F.#..
H........A
...#..#...
...####...
##......##
B........B
